+----------+
|C         |
+-+        +-+
  |          |
  +------+   |
  +------+   |
  |          |
  |    ++    |
  |    ||    |
  |T   ||    |
  +----++----+
