+--------+
|C  T   G|
|   |    |
|  -+----|
|   |    |
|        |
+--------+
