a	affiche1.jpg

+--------+
|C  a   G|
|   |    |
|  -+----|
|   |    |
|       T|
+--------+
