a	affiche1.jpg

+--------+
|C  X   G|
|   |    |
|  -+----|
|   |    |
|       T|
+--------+
